1111111111111111100111111
0000000000000000000000011
1000000000100000000101001
1001000000100000000100011
1000010001000000000001111
1000010100110000100010001
1000000000000010100000001
1000000000100100000001011
1111111111111111111001111
1110000100001001000000000
1000000000000000000000011
1000000000100001000010001
1001000000100000000000111
1000010001000000000100111
1000010100110000100010001
1000000000000001000000011
1000000010010000000001011
1001000000000001000011001
1000000000100000000000001
1000000000000010000000001
1000000000100010000010001
1001000000100010000000011
1000101000100000000000111
1000000101000001010000001
1111111111111100111111111