NO ./path_to_the_north_texture
SO ./path_to_the_south_texture
WE ./path_to_the_west_texture
EA ./path_to_the_east_texture

F 220,100,0
C 225,30,0



        1111111111111111111111111
        1000N00001100000000000001
        1011000001110001000000001
        1001000000000000000000011
111111111011000001110000000000001
10000000001100000111011111111111
111101111111110111000000100011
111101111111110111010100100011
110000001101010111000001000111
100000000000000011000000100011
110000011101010111110111100111
11010111 1110101 1011110100011
    10111   111111111111111111
111111110111111101111111111111
    11111111111111111111111111
